R  1024 768
NO textures/wood.xpm
SO textures/wood.xpm
WE textures/mossy.xpm
EA textures/mossy.xpm

S textures/pillar.xpm
F textures/stone.xpm
C textures/bluebrick.xpm
111111
120021
102001
1000W1
111111